xWWWWWWWWWWWWWW WWWWWWWWWWWWWWWx
xW        WxxxW WxxxW    WW   Wx
xW WWW WW WxxxW WxxxW WW WW W Wx
xWOWWW WW WxxxW WxxxW WW    WOWx
xW WWW WW WxxxW WxxxW WW WW W Wx
xW WWW WW WWWWW WWWWW WW WW W Wx
xW                          W Wx
xW WWW WWWWWWWW WWWWW WWWWWWW Wx
xW WWW WWWWWWWW WWWWW WWWWWWW Wx
xW WWW    WW   g      WW    W Wx
xW WWW WW WW WW-WW WW WW WW W Wx
xW WWW WW    WGGGW WW WW WW W Wx
S      WWWWW WWWWW WW    WW    S
xWWWWW WWWWW   o   WWWWW WWWW Wx
xWWWWW WWWWW WW WW WWWWW WWWW Wx
S      WWWWW WW WW WW    WW    S
xW WWW WW    WW WW WW WW WW W Wx
xW WWW WW WW WW WW WW WW WW W Wx
xWOWWW    WW          WW    WOWx
xW WWW WWWWWWWW WWWWW WWWWWWW Wx
xW WWW WWWWWWWW WWWWW WWWWWWW Wx
xW                          W Wx
xW WWW WW WWWWW WWWWW WWWWW W Wx
xW WWW WW WxxxW WxxxW WWWWW W Wx
xW WWW WW WxxxW WxxxW WW    W Wx
xW WWW WW WxxxW WxxxW WW WW W Wx
xW        WxxxW WxxxW    WW   Wx
xWWWWWWWWWWWWWW WWWWWWWWWWWWWWWx
