WWWWWWWWWWWWWWxWWWWWWWWWWWWWWW
WxxxxxxxxWxxxWxWxxxWxxxxWWxxxW
WxWWWxWWxWxxxWxWxxxWxWWxWWxWxW
WxWWWxWWxWxxxWxWxxxWxWWxxxxWxW
WxWWWxWWxWxxxWxWxxxWxWWxWWxWxW
WxWWWxWWxWWWWWxWWWWWxWWxWWxWxW
WxxxxxxxxxxxxxxxxxxxxxxxxxxWxW
WxWWWxWWWWWWWWxWWWWWxWWWWWWWxW
WxWWWxWWWWWWWWxWWWWWxWWWWWWWxW
WxWWWxxxxWWxxxxxxxxxxWWxxxxWxW
WxWWWxWWxWWxWW-WWxWWxWWxWWxWxW
WxWWWxWWxxxxWxxxWxWWxWWxWWxWxW
xxxxxxWWWWWxWWWWWxWWxxxxWWxxxx
WWWWWxWWWWWxxxxxxxWWWWWxWWWWxW
WWWWWxWWWWWxWWxWWxWWWWWxWWWWxW
xxxxxxWWWWWxWWxWWxWWxxxxWWxxxx
WxWWWxWWxxxxWWxWWxWWxWWxWWxWxW
WxWWWxWWxWWxWWxWWxWWxWWxWWxWxW
WxWWWxxxxWWxxxxxxxxxxWWxxxxWxW
WxWWWxWWWWWWWWxWWWWWxWWWWWWWxW
WxWWWxWWWWWWWWxWWWWWxWWWWWWWxW
WxxxxxxxxxxxxxxxxxxxxxxxxxxWxW
WxWWWxWWxWWWWWxWWWWWxWWWWWxWxW
WxWWWxWWxWxxxWxWxxxWxWWWWWxWxW
WxWWWxWWxWxxxWxWxxxWxWWxxxxWxW
WxWWWxWWxWxxxWxWxxxWxWWxWWxWxW
W   xxxxxWxxxWxWxxxWxxxxWWxxxW
WWWWWWWWWWWWWWxWWWWWWWWWWWWWWW