WWWWWWWWWWWW WW WWWWWWWWWWWW
W            WW            W
W WWWW WWWWW WW WWWWW WWWW W
W WWWW WWWWW WW WWWWW WWWW W
W WWWW WWWWW WW WWWWW WWWW W
W                          W
W WWWW WW WWWWWWWW WW WWWW W
W WWWW WW WWWWWWWW WW WWWW W
W      WW   WWWW   WW      W
WWWWWW WWWW WWWW WWWW WWWWWW
WxxxxW WWWW WWWW WWWW WxxxxW
WxxxxW WW          WW WxxxxW
WxxxxW WW WWWW WWW WW WxxxxW
WWWWWW WW WWWW WoW WW WWWWWW
               Wo|          
WWWWWW WW WWWW WoW WW WWWWWW
WxxxxW WW WWWW WWW WW WxxxxW
WxxxxW WW          WW WxxxxW
WxxxxW WW WWWWWWWW WW WxxxxW
WWWWWW WW WWWWWWWW WW WWWWWW
W            WW            W
W WWWW WWWWW WW WWWWW WWWW W
W WWWW WWWWW WW WWWWW WWWW W
W   WW WW          WW      W
WWW WW WW WWWWWWWW WW WW WWW
WWW WW WW WWWWWWWW WW WW WWW
W      WW    WW    WW      W
W WWWWWWWWWW WW WWWWWWWWWW W
W WWWWWWWWWW WW WWWWWWWWWW W
W                          W
WWWWWWWWWWWW WW WWWWWWWWWWWW
