WWWWWWWWWWWWWWoWWWWWWWWWWWWWWW
WooooooooWoooWoWoooWooooWWoooW
WoWWWoWWoWoooWoWoooWoWWoWWoWoW
WoWWWoWWoWoooWoWoooWoWWooooWoW
WoWWWoWWoWoooWoWoooWoWWoWWoWoW
WoWWWoWWoWWWWWoWWWWWoWWoWWoWoW
WooooooooooooooooooooooooooWoW
WoWWWoWWWWWWWWoWWWWWoWWWWWWWoW
WoWWWoWWWWWWWWoWWWWWoWWWWWWWoW
WoWWWooooWWooooooooooWWooooWoW
WoWWWoWWoWWoWW-WWoWWoWWoWWoWoW
WoWWWoWWooooWoooWoWWoWWoWWoWoW
ooooooWWWWWoWWWWWoWWooooWWoooo
WWWWWoWWWWWoooooooWWWWWoWWWWoW
WWWWWoWWWWWoWWoWWoWWWWWoWWWWoW
ooooooWWWWWoWWoWWoWWooooWWoooo
WoWWWoWWooooWWoWWoWWoWWoWWoWoW
WoWWWoWWoWWoWWoWWoWWoWWoWWoWoW
WoWWWooooWWooooooooooWWooooWoW
WoWWWoWWWWWWWWoWWWWWoWWWWWWWoW
WoWWWoWWWWWWWWoWWWWWoWWWWWWWoW
WooooooooooooooooooooooooooWoW
WoWWWoWWoWWWWWoWWWWWoWWWWWoWoW
WoWWWoWWoWoooWoWoooWoWWWWWoWoW
WoWWWoWWoWoooWoWoooWoWWooooWoW
WoWWWoWWoWoooWoWoooWoWWoWWoWoW
W   oooooWoooWoWoooWooooWWoooW
WWWWWWWWWWWWWWoWWWWWWWWWWWWWWW