WWWWWWWWWWWWWW WWWWWWWWWWWWWWW
W        WxxxW WxxxW    WW   W
W WWW WW WxxxW WxxxW WW WW W W
WOWWW WW WxxxW WxxxW WW    WOW
W WWW WW WxxxW WxxxW WW WW W W
W WWW WW WWWWW WWWWW WW WW W W
W                          W W
W WWW WWWWWWWW WWWWW WWWWWWW W
W WWW WWWWWWWW WWWWW WWWWWWW W
W WWW    WW   g      WW    W W
W WWW WW WW WW-WW WW WW WW W W
W WWW WW    WGGGW WW WW WW W W
S     WWWWW WWWWW WW    WW   S
WWWWW WWWWW   o   WWWWW WWWW W
WWWWW WWWWW WW WW WWWWW WWWW W
S     WWWWW WW WW WW    WW   S
W WWW WW    WW WW WW WW WW W W
W WWW WW WW WW WW WW WW WW W W
WOWWW    WW          WW    WOW
W WWW WWWWWWWW WWWWW WWWWWWW W
W WWW WWWWWWWW WWWWW WWWWWWW W
W                          W W
W WWW WW WWWWW WWWWW WWWWW W W
W WWW WW WxxxW WxxxW WWWWW W W
W WWW WW WxxxW WxxxW WW    W W
W WWW WW WxxxW WxxxW WW WW W W
W        WxxxW WxxxW    WW   W
WWWWWWWWWWWWWW WWWWWWWWWWWWWWW
