WWWWWWWWWWWWWW WWWWWWWWWWWWWWW
W        WxxxW WxxxW    WW   W
W WWW WW WxxxW WxxxW WW WW W W
W WWW WW WxxxW WxxxW WW    W W
W WWW WW WxxxW WxxxW WW WW W W
W WWW WW WWWWW WWWWW WW WW W W
W                          W W
W WWW WWWWWWWW WWWWW WWWWWWW W
W WWW WWWWWWWW WWWWW WWWWWWW W
W WWW    WW          WW    W W
W WWW WW WW WW-WW WW WW WW W W
W WWW WW    WoooW WW WW WW W W
      WWWWW WWWWW WW    WW    
WWWWW WWWWW   o   WWWWW WWWW W
WWWWW WWWWW WW WW WWWWW WWWW W
      WWWWW WW WW WW    WW    
W WWW WW    WW WW WW WW WW W W
W WWW WW WW WW WW WW WW WW W W
W WWW    WW          WW    W W
W WWW WWWWWWWW WWWWW WWWWWWW W
W WWW WWWWWWWW WWWWW WWWWWWW W
W                          W W
W WWW WW WWWWW WWWWW WWWWW W W
W WWW WW WxxxW WxxxW WWWWW W W
W WWW WW WxxxW WxxxW WW    W W
W WWW WW WxxxW WxxxW WW WW W W
W        WxxxW WxxxW    WW   W
WWWWWWWWWWWWWW WWWWWWWWWWWWWWW
