WWWWWWWWWWWW WW WWWWWWWWWWWW
W            WW            W
W WWWW WWWWW WW WWWWW WWWW W
W WWWW WWWWW WW WWWWW WWWW W
W WWWW WWWWW WW WWWWW WWWW W
W                          W
W WWWW WW WWWWWWWW WW WWWW W
W WWWW WW WWWWWWWW WW WWWW W
W      WW    WW    WW      W
WWWWWW WWWW  WW  WWWW WWWWWW
WxxxxW WWWW  WW  WWWW WxxxxW
WxxxxW WW          WW WxxxxW
WxxxxW WW  BBBBBB  WW WxxxxW
WWWWWW WW  BBBBBB  WW WWWWWW
           BBBBBB           
WWWWWW WW  BBBBBB  WW WWWWWW
WxxxxW WW  BBBBBB  WW WxxxxW
WxxxxW WW          WW WxxxxW
WxxxxW WW WWWWWWWW WW WxxxxW
WWWWWW WW WWWWWWWW WW WWWWWW
W            WW            W
W WWWW WWWWW WW WWWWW WWWW W
W WWWW WWWWW WW WWWWW WWWW W
W   WW WW          WW      W
WWW WW WW WWWWWWWW WW WW WWW
WWW WW WW WWWWWWWW WW WW WWW
W      WW    WW    WW      W
W WWWWWWWWWW WW WWWWWWWWWW W
W WWWWWWWWWW WW WWWWWWWWWW W
W                          W
WWWWWWWWWWWW WW WWWWWWWWWWWW
