WWWWWWWWWWWWWWSWWWWWWWWWWWWWWW
WooooooooWxxxWoWxxxWooooWWoooW
WoWWWoWWoWxxxWoWxxxWoWWoWWoWoW
WOWWWoWWoWxxxWoWxxxWoWWooooWOW
WoWWWoWWoWxxxWoWxxxWoWWoWWoWoW
WoWWWoWWoWWWWWoWWWWWoWWoWWoWoW
WooooooooooooooooooooooooooWoW
WoWWWoWWWWWWWWoWWWWWoWWWWWWWoW
WoWWWoWWWWWWWWoWWWWWoWWWWWWWoW
WoWWWooooWWooogooooooWWooooWoW
WoWWWoWWoWWoWW-WWoWWoWWoWWoWoW
WoWWWoWWooooWGGGWoWWoWWoWWoWoW
SoooooWWWWWoWWWWWoWWooooWWoooS
WWWWWoWWWWWoooooooWWWWWoWWWWoW
WWWWWoWWWWWoWWoWWoWWWWWoWWWWoW
SoooooWWWWWoWWoWWoWWooooWWoooS
WoWWWoWWooooWWoWWoWWoWWoWWoWoW
WoWWWoWWoWWoWWoWWoWWoWWoWWoWoW
WOWWWooooWWooooooooooWWooooWOW
WoWWWoWWWWWWWWoWWWWWoWWWWWWWoW
WoWWWoWWWWWWWWWWWWWWoWWWWWWWoW
WooooooooooooooooooooooooooWoW
WoWWWoWWoWWWWWoWWWWWoWWWWWoWoW
WoWWWoWWoWxxxWoWxxxWoWWWWWoWoW
WoWWWoWWoWxxxWoWxxxWoWWooooWoW
WoWWWoWWoWxxxWoWxxxWoWWoWWoWoW
W   oooooWxxxWoWxxxWooooWWoooW
WWWWWWWWWWWWWWSWWWWWWWWWWWWWWW
