WWWWWWWWWWWWoWWoWWWWWWWWWWWW
WooooooooooooWWooooooooooooW
WoWWWWoWWWWWoWWoWWWWWoWWWWoW
WoWWWWoWWWWWoWWoWWWWWoWWWWoW
WoWWWWoWWWWWoWWoWWWWWoWWWWoW
WooooooooooooooooooooooooooW
WoWWWWoWWoWWWWWWWWoWWoWWWWoW
WoWWWWoWWoWWWWWWWWoWWoWWWWoW
WooooooWWooooWWooooWWooooooW
WWWWWWoWWWWooWWooWWWWoWWWWWW
WxxxxWoWWWWooWWooWWWWoWxxxxW
WxxxxWoWWooooooooooWWoWxxxxW
WxxxxWoWWooBBBBBBooWWoWxxxxW
WWWWWWoWWooBBBBBBooWWoWWWWWW
oooooooooooBBBBBBooooooooooo
WWWWWWoWWooBBBBBBooWWoWWWWWW
WxxxxWoWWooBBBBBBooWWoWxxxxW
WxxxxWoWWooooooooooWWoWxxxxW
WxxxxWoWWoWWWWWWWWoWWoWxxxxW
WWWWWWoWWoWWWWWWWWoWWoWWWWWW
WooooooooooooWWooooooooooooW
WoWWWWoWWWWWoWWoWWWWWoWWWWoW
WoWWWWoWWWWWoWWoWWWWWoWWWWoW
WoooWWoWWooooooooooWWooooooW
WWWoWWoWWoWWWWWWWWoWWoWWoWWW
WWWoWWoWWoWWWWWWWWoWWoWWoWWW
WooooooWWooooWWooooWWooooooW
WoWWWWWWWWWWoWWoWWWWWWWWWWoW
WoWWWWWWWWWWoWWoWWWWWWWWWWoW
W   oooooooooooooooooooooooW
WWWWWWWWWWWWoWWoWWWWWWWWWWWW
